#########
###.#.###
###...###
###.#.###
###.#....
#########

