#########
###.#.###
###234###
###1#5###
###0#6789
#########
